2000000003
1........1
1200000005
1400000003
1........1
4009000005

0333333333
0........2
0111111112
0233333333
0........2
1111111112


