.2003.....
.1..1.....
.1..46783.
.1......1.
.40903..1.
.....4005.

.0333.....
.0..2.....
.0..23343.
.0......2.
.11110..2.
.....1112.


