.20900003.
.40032005.
.20054003.
.12000031.
.14032051.
.40054005.

.11111110.
.23330333.
.11121110.
.20333330.
.21101120.
.23332333.

