2000320003
1200540031
11......11
11......11
1400000051
4000900005

0333303333
0111211102
02......02
02......02
0233333332
1111111112

